1111111111111111111
1P0001C0000000000C1
100C011111000000001
1000000000C00011111
10C0000000000000E01
1111111111111111111
