111111111111111111111111111
1CPCCCCCC1CCCCCCCCCCC1CCCC1
1CCCCCCCC1CCCCCCCCCCC1CECC1
1CCCCCCCCCCCCCCCCCCCC111111
1CCCCCCCC1CCCCCCCCCCCCCCCC1
1CCCCCCCCC1CCCCCCCCCCCCCCC1
1CCCCCCCC1CCCCCCCCCCCCCCCC1
1CCCCCCCCC1CCCCCCCCCCCCCCC1
1CCCCCCCC1CCCCCCCCCCCCCCCC1
1CCCCCCCCC1CCCCCCCCCCCCCCC1
1CCCCCCCC1CCCCCCCCCCCCCCCC1
1CCCCCCC0C1CCCCCCCCCCCCCCC1
1CCCCCCCC1CCCCCCCCCCCCCCCC1
1CCCCCCCCC1CCCCCCCCCCCCCCC1
111111111111111111111111111
